11111111111111111111
00000000000000000031
11111111111111111101
11111111111111111101
11111111111111111101
11111111111111111101
15000000000000000041
10111111111111111111
10111111111111111111
10111111111111111111
10111111111111111111
10111111111111111111
16000000000000000000
