11111111111111111111
00000031115000000031
11111101110111111101
11111160004111111101
11111111111111111101
15000000000000000041
10111111111111111111
10111115000003111111
16000004111110111111
11111111111110111111
15000000000004111111
10111111111111111111
16000000000000000000
