11111111111111111111
00003111111111111111
11110111115000031111
11116000004111101111
11111111111111101111
15000000000000041111
10111111111111111111
16000000000003111111
11111111111110111111
11111111111110111111
11111111111110111111
11111111111110111111
11111111111116000000
