1111111111111111111111111
1111111111111111111111111
1111000000000000000211111
1111000300000000000011111
1111000000000000000011111
1111000000000000000001111
1111000000080000000001111
1111000000000000000001111
1111000000000000000001111
1111000400000000000001111
1111111111111111111001111
1111111111111111111101111
1111111111111111111101111