1111111111111111111111111
1111111111111111111111111
1111111111111111111111111
1111111111111111111111111
1111111111111111111111111
1111111111111111111111111
1000000000000000031111111
1111111111111111101111111
1111111111111111101111111
1111111111111111160031111
1111111111111111111101111
1111111111111111111101111
1111111111111111111101111