1111010000000000000000000
0000010000030000000000000
0000010000000000000000000
0000000000005000000000000
0000000000000000002000000
0000000000000000000000000
0011100000000000000300000
0010100000000000000000000
0010100000000000000000000
0110101000000000000000000
0100001000000000000400000
0111111000000000000000000
0000000000000000000000000