1110000000000000001111111
1111000000000000011111111
1111000111111000002001111
1111000111111000000001111
1111000111111000000001111
1111000111111700000001111
1111000000000000000001111
1111000000000000000001111
1111000000000000000001111
1111000000000000000000000
1111311111111111111111111
1111111111111111111111111
1111111111111111111111111