1110000000000000000000000
1111000000000000000000000
111100a000000000000000000
1111000000000000000000000
1111000000000900000000000
1111000000000000000000010
1111000011111001111110010
1111020011111001111110010
1111000011111001111110010
1111111111111001111100000
0000000000000000000000000
1111000000000000000000000
1111000000000000000000000