1111111111110111111111111
1111111111110111111111111
1111111111110111111111111
1111111111110111111111111
1111111111110111111111111
1111111111116000000000311
1111111111111111111111011
1111111111111111111111011
1111111111111111111111011
1111111111111111111111011
0000000000000000000000411
1111111111111111111111111
1111111111111111111111111